111111111111111
1E1000000000C01
101001010011111
101001001010101
1P0000000C00C01
111111111111111