1111111111111111111111
1000000000000000001001
1PP0000000010010000001
100000E0000E00000C0111
1111111111111111111111