1111111111111111111111
1000000000000000001001
1P00000000010010000001
1000000P000E00000C0111
1111111111111111111111