1111111111111111111111
10000E0000000000001001
10000P000N0100100C0001
1000000000000000000111
1111111111111111111111