1111111111111111111111111111111111111111
101000000000C000000000000C00000000000C01
1010010100111001000000000C001000000000C1
10100100101010C1000000000C0C1000000000C1
1P0C0011111C10C1000000000C0C1000000000C1
10010E00CC0C00C1000000000C01100000000011
100111001CC0C001000000000C001000000000C1
100111001CC0C001000000000C001000000000C1
100111001CC0C001000000000C001000000000C1
100111001CC0C001000000000C001000000000C1
100111001CC0C001000000000C001000000000C1
100111001CC0C001000000000C001000000000C1
100111001CC0C001000000000C001000000000C1
100111001CC0C001000000000C001000000000C1
1111111111111111111111111111111111111111