1111111111111111111111
1000000000000000001001
1P000000000100100C0001
10000000000E0000000111
1111111111111111111111