1111111111111111111
1000000000100000C01
100000011000000C001
1P0000000000C111111
11111110000C0000001
1000001111000000001
1E11100000000001111
1111111111111111111