11111111
10E00001
100PN0C1
11111111