1111111111111111111111
10000N0000000000001001
1P00000000010010000001
10000000N00E00000C0111
1111111111111111111111
