1111111111111111111111
10000000E0000000001001
1P000000N0010010000001
1000N000000E00000C0111
1111111111111111111111