1111111111
1C0100E101
11111000P1
10C0000001
1111111111